###########
#!  #     #
# #    ## #
# # #  #  #
# #   ##  #
# ####  # #
#   #   ###
#   # #   #
#     ##  #
#    #    #
###### ####